0 0 0 0 0 0 0 0 0 0 0 0 0 0 0 0 0 0 0 0
0 0 0 0 8 8 8 8 8 8 8 8 8 8 0 0 0 0 0 0
0 0 0 6 1 1 1 1 1 1 1 1 1 1 5 0 0 0 0 0
0 0 0 6 1 2 3 3 3 3 3 3 4 1 5 0 0 0 0 0
0 0 0 6 1 5 0 0 0 0 0 0 6 1 5 0 0 0 0 0
0 0 0 6 1 5 0 0 0 0 0 0 6 1 5 0 0 0 0 0
8 8 8 9 1 7 8 8 8 8 8 8 9 1 7 8 8 8 8 0
1 1 1 1 1 1 1 1 1 1 1 1 1 1 1 1 1 1 1 5
3 3 3 4 1 2 3 3 3 3 3 3 4 1 2 3 3 4 1 5
0 0 0 6 1 5 0 0 0 0 0 0 6 1 5 0 0 6 1 5
0 0 0 6 1 5 0 0 0 0 0 0 6 1 7 8 8 9 1 5
0 0 0 6 1 5 0 0 0 0 0 0 6 1 1 1 1 1 1 5
8 8 8 9 1 5 0 0 0 0 0 0 0 3 3 3 3 3 3 0
1 1 1 1 1 5 0 0 0 0 0 0 0 0 0 0 0 0 0 0
3 3 3 3 3 0 0 0 0 0 0 0 0 0 0 0 0 0 0 0